40
11,7,6,6,6,12,11,7,12,7,12,7,5,13,1,6,6,6,6,6,1,6,6,6,1,6,6,6,6,6,1,6,6,6,6,1,1,6,1,5
9,10,1,6,6,6,2,4,12,9,13,3,10,5,4,6,6,6,6,5,9,7,6,5,9,7,6,1,6,1,2,7,6,6,12,9,9,14,9,9
9,15,4,1,5,7,8,9,13,0,6,,6,3,3,6,6,0,5,9,9,9,11,9,9,9,15,9,15,9,9,10,6,6,5,9,4,2,9,9
10,6,0,8,14,9,7,0,5,10,5,9,13,6,6,6,5,4,2,9,4,0,8,9,14,4,6,0,6,2,9,7,6,6,8,9,9,9,9,9
7,12,9,7,1,0,2,10,3,5,4,3,6,6,6,5,9,10,8,9,9,9,7,3,12,9,15,9,15,9,9,10,6,6,5,9,9,4,2,9
9,7,3,3,3,3,0,6,12,9,9,7,6,6,6,2,10,6,6,3,3,3,3,6,6,0,6,3,6,3,3,6,6,6,8,9,9,9,9,9
9,10,6,12,11,11,4,6,6,2,9,9,7,6,12,9,15,15,7,1,6,6,6,6,6,3,5,15,15,7,6,6,6,6,6,8,9,14,9,9
9,7,6,6,0,2,9,7,6,0,8,9,9,7,6,0,8,9,9,7,6,0,5,15,9,10,6,6,6,6,1,6,8,15,7,8,7,6,6,5,13,6,3,6,2,9
9,9,11,11,14,9,10,8,11,9,13,8,9,4,12,9,14,15,10,5,10,1,1,5,4,1,12,15,9,7,0,6,12,4,6,6,6,5,9,9
10,2,10,3,6,0,6,6,8,4,6,6,8,10,6,3,5,15,15,10,5,4,8,14,9,14,15,15,9,9,14,13,6,2,13,6,5,9,9,9
15,4,1,6,2,9,13,6,1,2,7,6,6,6,6,5,4,5,15,15,14,9,7,1,8,15,15,7,8,4,6,6,12,10,6,6,8,9,9,9
15,9,10,6,8,9,7,6,8,9,9,7,6,5,9,9,10,12,15,15,9,9,9,15,15,7,8,7,8,6,6,6,6,6,6,8,9,9
7,2,7,6,8,9,10,6,5,9,9,7,5,9,9,10,6,5,11,15,10,2,14,15,7,8,7,3,5,9,7,1,6,6,6,6,6,2,9
10,2,10,6,5,4,6,6,8,9,10,2,14,9,14,10,6,12,4,8,15,15,4,12,15,9,7,8,11,14,9,14,13,6,1,6,5,9,9
15,9,13,6,8,9,15,15,15,4,12,4,6,3,6,1,1,6,0,6,5,15,9,15,7,8,9,13,3,6,3,12,4,1,5,14,11,9,9,9
15,4,6,5,13,2,7,6,6,8,7,3,6,6,5,9,9,11,9,13,3,5,14,7,8,13,3,6,6,6,6,6,3,3,3,6,3,2,9,9
7,8,15,4,5,9,10,6,6,6,3,6,6,12,9,9,9,4,0,6,12,9,15,4,6,6,6,6,6,6,6,6,6,6,6,6,12,9,9,9
9,15,15,4,2,10,6,6,6,6,6,6,6,6,0,0,2,14,9,7,1,8,4,10,5,13,6,5,7,6,6,1,1,6,6,6,6,8,9,9
9,15,4,3,6,6,6,6,6,6,1,6,6,9,9,10,1,8,4,8,15,9,15,10,1,5,9,14,7,1,3,0,6,1,6,1,6,2,9
9,15,7,2,7,6,6,6,6,6,6,2,7,5,9,10,5,4,1,2,15,15,9,15,15,9,10,8,7,3,8,11,9,15,9,13,2,15,9,9
9,1,3,2,9,7,6,6,6,6,5,4,8,9,4,5,9,4,8,14,15,11,9,11,15,10,1,1,2,13,6,2,9,15,4,12,9,15,9,9
4,8,15,9,9,9,7,6,6,5,9,10,6,8,9,9,14,4,12,15,15,9,9,9,15,15,14,9,10,6,6,3,2,15,10,6,8,15,9,9
9,15,15,9,9,9,9,13,5,9,9,7,6,5,9,4,6,8,15,15,7,8,9,10,5,15,15,14,7,1,6,5,9,7,6,1,6,5,9,9
9,15,15,9,9,9,4,6,2,9,9,9,11,9,9,4,12,15,15,7,8,11,9,11,4,12,15,15,9,9,7,8,9,10,5,9,7,8,9,9
9,15,7,8,14,9,10,12,9,14,9,9,10,8,9,4,12,15,7,2,13,2,9,9,9,7,5,15,14,9,10,5,9,7,8,9,10,5,9,9
4,6,3,6,6,0,6,6,3,6,0,3,6,12,9,9,15,15,4,13,12,9,9,9,4,8,14,15,15,9,13,8,9,10,12,9,13,8,9,9
4,6,6,1,5,9,7,6,6,5,9,7,6,6,3,2,7,6,8,7,1,2,9,10,3,6,6,6,6,3,6,6,3,6,6,3,6,6,8,9
9,15,15,9,9,9,9,7,5,9,9,4,1,6,6,8,9,7,6,3,3,8,10,6,1,6,6,6,6,6,6,6,6,6,6,6,6,6,6,8
9,15,15,9,9,9,9,9,9,9,9,9,9,7,6,6,8,9,13,1,6,6,1,12,9,7,6,6,6,5,7,6,6,6,6,6,6,6,6,12
9,15,15,9,9,9,9,9,9,10,2,9,9,9,11,13,6,3,6,0,6,5,4,12,9,9,7,6,12,9,9,7,6,6,6,6,6,6,6,5,9
9,15,15,9,9,9,9,9,10,12,9,4,2,9,10,6,6,6,5,4,5,9,14,11,9,9,4,6,5,9,9,4,6,6,6,6,6,6,5,9
9,15,15,14,10,2,14,10,6,6,2,9,9,10,6,6,3,6,8,9,9,10,6,8,9,9,14,7,8,9,9,4,1,1,6,6,6,5,9,9
9,15,15,7,12,4,6,6,1,6,2,9,10,6,6,6,6,6,6,2,10,6,6,5,4,0,6,3,5,9,9,9,9,9,11,7,12,9,9,9,
9,15,15,9,7,0,6,6,0,6,2,20,6,6,6,6,6,6,5,4,6,6,6,2,9,9,7,5,9,9,9,9,9,10,8,4,6,8,9,9
9,15,15,,4,2,10,6,5,9,13,3,6,6,6,6,6,1,12,9,10,6,6,5,9,9,9,9,14,9,9,9,10,3,6,6,3,6,12,9,14
9,15,15,,9,4,1,,12,9,4,6,6,6,6,6,1,12,10,5,9,7,6,5,9,9,9,9,4,6,8,4,0,6,6,1,1,1,6,6,3,5
9,15,15,9,9,14,7,8,9,11,13,6,6,5,9,15,15,9,9,9,11,14,9,9,9,9,9,13,5,9,9,15,15,9,9,9,12,6,6,2
4,6,6,8,4,6,2,7,3,3,6,6,5,9,14,15,15,9,9,9,10,6,8,9,9,9,10,6,8,9,9,15,15,9,9,10,6,6,12,9
9,15,15,13,2,11,9,9,7,6,6,12,9,4,6,6,6,8,9,10,6,6,6,8,9,10,,6,6,6,8,9,7,6,8,10,6,6,6,6,8
14,15,15,13,6,3,3,3,3,6,6,6,8,14,,15,15,15,15,10,6,6,6,6,6,3,6,6,6,6,6,8,10,6,6,6,6,6,6,6,13